11111111111111111
1CP01111000000C01
111000000E0000001
1C0001000111100C1
11111111111111111
