11111111111111111
1CP111110E0000C01
11000000000000001
11111111111111111
