11111111111111111
1C0111110E0000C01
11000P0000S000001
11111111111111111
